Year,Population_Behavior,Road_Environment,Motor_Vehicle_Condition,Estimated_Total,Total_RTAs
2011,17828,2585,1661,22074,22272
2012,15422,3300,1076,19798,19870
2013,15394,3194,646,19234,18368
2014,16387,3206,714,20307,18686
2015,15958,3171,717,19846,18495
2016,13564,910,1206,15680,14557
2017,12179,1065,1618,14862,13244
2018,11851,602,1419,13872,12805
2019,11948,531,1451,13930,12858
2020,11038,318,893,12249,12249
